20.ox
............o.....oo
..o.o...oo...o......
....oo......o.......
..................oo
o...oo...........ooo
...o.o..o...o.oo.o..
.....o...........o..
.o.o........oo......
.o.oo.o...oo...oo...
.............ooo....
......o.o....o..ooo.
...o.o..o..oo.o.....
..o................o
..o.....o........o.o
......o.o..o..o.o...
o.o.o..o.ooo........
o...ooo......o.o....
.....o.o....o.......
o.o......o.oo...o.oo
.o...o.....o...o....
