20-/@
----/------------/----------------------
/--------------/--//--------------------
----------------------------------------
---/--------------/------------------/--
----//---------------------/------------
/--/-----------------/-------/---------/
---------------------/------------------
-----------/-/------------/-------------
-------/------------------------------/-
--//-----------------------------/------
-----//-----/----/------------------/---
----------------------------------------
----/--//---/------------/---/----------
-------------/-------------------------/
--/----------/-/-------------------/--/-
-------------/-----------------//---/-/-
-/---/------------/----------/----------
-------------------------------------/--
------/-------------------/---/-/-/-----
-------/--/---------/----/--------------
